0000000000000000000000000000000000000000000000000000000000000000000000000000000000000000000000000000000000000000000000000000000000000000000000000000000000000000000000000000000000000000000000000000000000000000000000000000000000000000000000000000000000000000000000000000000000000
0000000000000000000000000000000000000000000000000000000000000000000000000000000000000000000000000000000000000000000000000000000000000000000000000000000000000000000000000000000000000000000000000000000000000000000000000000000000000000000000000000000000000000000000000000000000000
0000000000000000000000000000000000000000000000000000000000000000000000000000000000000000000000000000000000000000000000000000000000000000000000000000000000000000000000000000000000000000000000000000000000000000000000000000000000000000000000000000000000000000000000000000000000000
0000000000000000000000000000000000000000000000000000000000000000000000000000000000000000000000000000000000000000000000000000000000000000000000000000000000000000000000000000000000000000000000000000000000000000000000000000000000000000000000000000000000000000000000000000000000000
0000000000000000000000000000000000000000000000000000000000000000000000000000000000000000000000000000000000000000000000000000000000000000000000000000000000000000000000000000000000000000000000000000000000000000000000000000000000000000000000000000000000000000000000000000000000000
0000000000000000000000000000000000000000000000000000000000000000000000000000000000000000000000000000000000000000000000000000000000000000000000000000000000000000000000000000000000000000000000000000000000000000000000000000000000000000000000000000000000000000000000000000000000000
0000000000000000000000000000000000000000000000000000000000000000000000000000000000000000000000000000000000000000000000000000000000000000000000000000000000000000000000000000000000000000000000000000000000000000000000000000000000000000000000000000000000000000000000000000000000000
0000000000000000000000000000000000000000000000000000000000000000000000000000000000000000000000000000000000000000000000000000000000000000000000000000000000000000000000000000000000000000000000000000000000000000000000000000000000000000000000000000000000000000000000000000000000000
00000000000000000000000000000000000000000000000000000000000000000000000000000000000000000000000000000000000000000000000000000000000000000000000000000000000000000000000000000000000000000000000000000000000000000000000000000000000000000000000000000004444444444444444444444444444444444444444444444444444444444444444444
00000000000000000000000000000000000000000000000000000000000000000000000000000000000000000000000000000000000000000000000000000000D00000000000000000000000000000000000000000000000000000000000000000000000000000000000000000000000000000000000000000000004444444444444444444444444444444444444444444444444444444444444444444
00000000000000000000000000000000000000000000000000000000000000000000000000000000000000000000000000000000L02222222222222222222222C22222222222222222222222222220000000000000000000000000000000000000000000000000000000000000000000000000000000000000000004444444444444444444444444444444444444444444444444444444444444444444
0000000000000000000000000000000000000000000000000000000000000000000000000000000000000000000000000000000L110000000000000000000000000000000000000000000000000010000000000000000000000000000000000000000000000000000000000000000000000000000000000000000004444444444444444444444444444444444444444444444444444444444444444444
000000000000000000000000000000000000000000000000000000000000000000000000000000000000000000000000000000L1110000000000000000000000000000000000000000000000000011R00000000000000000000000000000000000000000000000000000000000000000000000000000000000000004444444444444444444444444444440000000000000000000000000000000044444
00000000000000000000000000000000000000000000000000000000000000000000000000000000000000000000000000000L111100000000000000000000000000000000000000000000000000111R0000000000000000000000000044000000000000000000000000000000000000000000000000000000000004444444444444444444444444444440000000000000000000000000000000044444
0000000000000000000000000000000000000000000000000000000000000000000000000000000000000000000000000000L11111000000000000000000000000000000000000000000000000001111R000000000000000000000000000000000000000000000000000000000000000000000000000000000000004444444444444444444444444444440000000000000000000000000000000044444
00044P440000000000000000000000000000000000000000000000000000000000000000000000000000000000000000000L1111110000000000000000000000000000000000000000000000000011111R00000000000000000000000033000000000000000000000000000000000000000000000000000000000004444444444444444444444444444440000000000000000000000000000000044444
00000000000000000000000000000000000000000000000000000000000000000000000000000000000000000000000000L111111100000000000000000000000000000000000000000000000000111111R00000000000000000000004P4440000000000000000000000000000000000000000000000000000000000000000000000000000000000000000000000000000000000000000000000044444
00000000000000000000000000000000000000000000000000000000000000000000000000000111111000000000011111111111110000000000000000000000000000000000000000000000000011111111111100000000000000000000000000000000000000001111100000000000000000000000000000000000000000000000000000000000000000000000000000000000000000000000044444
000000000000333333300L11R0000000000000000000000000000000000000000001111111000000000000111110011111111111110000000000000000000000000000000000000000000000000011111111111100000000000003333300003330000000000000001111100000000000000000003333333333300000000000000000000000000000000000000000000000000000000000000000044444
11111111111111111111111111111111111111111111000001111111111111110001111111000000000000111110011111111111110000000000000000000000000000000000000000000000000011111111111100000111111111111111111111111111111111111111111111111111100001111111111111111111111111111111111111111111114400000000000000000000000000000000044444
11111111111111111111111111111111111111111111000001111111111111110001111111000000000000000000011111111111110000000000000000000000000000000000000000000000000011111111111100000111111111111111111111111111111111111111111111111111100001111111111111111111111111111111111111111111114400000000000000000000000000000000044444
1111111111111111111111111111111111111111111100000111111111111111000111111100000000000000000001111111111111000000000000000000000000000000000000000000000000001111111111110000011111111111111111111111111111111111111111111111111110000111111111111111111111111111111111111111111111440000000000000000S000000000000000044444
11111111111111111111111111111111111111111111000001111111111111110001111111000000000000000000011111111111110000000000000000000000000000000000000000000000000011111111111100000111111111111111111111111111111111111111111111111111100001111111111111111111111111111111111111111111114444444444444444444444444444444444444444
11111111111111111111111111111111111111111111000001111111111111110001111111000000000000000000011111111111110000000000000000000000000000000000000000000000000011111111111100000111111111111111111111111111111111111111111111111111100001111111111111111111111111111111111111111111114444444444444444444444444444444444444444
11111111111111111111111111111111111111111111000001111111111111110001111111000000000000000000011111111111110000000000000000000000000000000000000000000000000011111111111100000111111111111111111111111111111111111111111111111111100001111111111111111111111111111111111111111111111111111111111111111111111111111111111111
11111111111111111111111111111111111111111111000001111111111111110001111111000000000000000000011111111111110000000000000000000000000000000000000000000000000011111111111100000111111111111111111111111111111111111111111111111111100001111111111111111111111111111111111111111111111111111111111111111111111111111111111111
11111111111111111111111111111111111111111111000001111111111111110001111111000000000000000000011111111111110000000000000000000000000000000000000000000000000011111111111100000111111111111111111111111111111111111111111111111111100001111111111111111111111111111111111111111111111111111111111111111111111111111111111111
11111111111111111111111111111111111111111111000001111111111111110001111111000000000000000000011111111111110000000000000000000000000000000000000000000000000011111111111100000111111111111111111111111111111111111111111111111111100001111111111111111111111111111111111111111111111111111111111111111111111111111111111111
11111111111111111111111111111111111111111111000001111111111111110001111111000000000000000000011111111111110000000000000000000000000000000000000000000000000011111111111100000111111111111111111111111111111111111111111111111111100001111111111111111111111111111111111111111111111111111111111111111111111111111111111111
11111111111111111111111111111111111111111111000001111111111111110001111111000000000000000000011111111111110000000000000000000000000000000000000000000000000011111111111100000111111111111111111111111111111111111111111111111111100001111111111111111111111111111111111111111111111111111111111111111111111111111111111111
